################
#  * *  * * * *#
# ############ #
#*#* * % * * #*#
# # ######## # #
#*#*#* $ H*#*#*#
# # #*# ##*# # #
#*#*###D####F#*#
#*#*#  * * #*#*# 
# # #*##*### # #
#*#*# + * * *#*#
# # * ###### # #
#* *# * * * * ^#
################