15 15
###############
# #* * * * * *#
# # ####### # #
#*#*#* * *# #*#
# # # #####*# #
#* $#*# * # #*#
# # # #*#*#*# #
#*#*#*# # # #*#
# # # #*#*#*# # 
#F#*#*# # # #*#
### # #*#*#$# #
#*# #D# # # # #
#  * * * * *  #
#  * * * * *  #
###############