################
#%#* * * * * *##
# # ####### # ##
#*#*#* * *# #*##
# # # #####*# ##
#* $#*# * # #*##
# # # #*#*#*# ##
#*#*#*# # # #*##
# # # #*#*#*# ##
#F#*#*# # # #*##
### # #*#*#$# ##
#*# #D# # # # ##
#  * * * * * ^##
################