
        P      ^
# %  #    #####
#    #      #
######      #
#  ^ #      # 
#    #    #####
        $
*** * * *** ****
*   * * *   *
*   *** *** ****
*   * * *  $   *
*** * * *** ****
             