################
#  * *    * * *#
# ############ #
#*#* * % * * #*#
# # ######## # #
#*#*#* $ H*#*#P#
# # #*# ##*# # #
#*#*###D####F#*#
#*#*#  * * #*#*# 
# # #*##*### # #
#*#*# + * * *#*#
# # * ###### # #
#* *# * * * * ^#
################