################
#%#* * *^* * *##
#*#*#* * *# #*##
# # # #####*# ##
#* H#*#F*+# #*##
# # # #*#*#*# ##
#*#*#*# # # #*##
# # # #*#*#*# ##
#F P *# # # #*##
### # #*#*#$# ##
#*#+# D # # #+##
# ###########D##
#  * * * * * ^##
################