################
#  *  ^ * * * *#
# ############ #
#*#* *  * * *#*#
# # ######## # #
#*#*#* $  *#*# #
# # #*# ##*# # #
#*#*###D####F#*#
#*#*#  * * #*#*# 
# # #*##*### # #
#*#*# * * * *#*#
# # * ###### # #
#* *# * * * * *#
################