################
#  * *  * * * *#
# ############ #
#*#* * % * * #*#
# # ######## # #
#*#*#* $  *#*# #
# # #*# ##*# # #
#*#*###D####F#*#
#*#*#  * * #*#*# 
# # #*##*### # #
#*#*# * * * *#*#
# # * ###### # #
#* *# * * * * ^#
################