15 15
###############
# #* * * * * *#
# # ####### # #
#*#*#* * *# #*#
# # # #####*# #
#*  #*#F* # #*#
# # # #*#*#*# #
#*#*#*# # # #*#
# # # #*#*#*# # 
#F * *# # # #*#
### # #*#*#$# #
#*# # D # # # #
# ###########D#
#  * * * * *  #
###############