################
# #* * * * * *##
#*#*#* * *# #*##
# # # #####*# ##
#*  #*#F* # #*##
# # # #*#*#*# ##
#*#*#*# # # #*##
# # # #*#*#*# ##
#F * *# # # #*##
### # #*#*#$# ##
#*# # D # # # ##
# ###########D##
#  * * * * *  ##
################