################
#%#* * * * * *##
#*#*#* * *# #*##
# # # #####*# ##
#*  #*#F* # #*##
# # # #*#*#*# ##
#*#*#*# # # #*##
# # # #*#*#*# ##
#F * *# # # #*##
### # #*#*#$# ##
#*# # D # # # ##
# ###########D##
#  * * * * * ^##
################